R 1920 1080
NO ./textures/xpm/bluestone.xpm
SO ./textures/xpm/colorstone.xpm
WE ./textures/xpm/greystone.xpm
EA ./textures/xpm/mossy.xpm
S ./textures/xpm/pillar.xpm
F 136,66,29
C 242,255,255
111111111111111111111111111111111111111111111111
100000110010110000110000000001000100010000100001
100000001000010010101001000101000000001001000001
100011110000000000001100100010000010000100100001
100000000000000110000001101100010000000011000111
101000000010110001001000000000100000000000100001
110000111100100110010100000010111000000110000001
101010000001000000000000001101110000000000010101
110110010000000100010000001010001001101110000101
100011000000110100001010000001001101100000110001
102000100011010000021011000000011000000000000001
100000100001000000000010000000000000010000010001
100001001000000000000000000000000000011000000001
100000100001001000101100001001000010000000100001
100101000000001000100000000010000000000000000101
100001001200001011000000010120011001000000000011
110000100000100001000000010100000000100000000001
100111000100010010100010001101100100000000000101
101110000000110000000000010000001000001001000001
1001000W0100000000000000100010101000110100000011
100001010000000002000000000100000000000100000101
100010101010101000011010000000000000000000101001
100100000000000001001000110010010001001010100101
100000000011000000010000010011001100010110000001
100000000000011000000000100000000000000010000001
100100000000000010010010100000011011010001000001
100000010100000001000002101001010000001000011011
100000000000011001000100100000000001000000101001
110011010000000000000001000002000100000000000001
100000100000000010000000000010010010100010010001
100000001000001000011000100000110000000001000101
110010000000100000100011000101001000000110000001
100010000000101000010010101001100011101000000001
110000000001001000000001000100100000010000000001
100010000000000000000000000001100000000000000101
100010001100000201010000010001010000000100001001
100000110000000010001001100000010000100101021011
111200000010110001000100010000000100000000001001
110010000010000111000000011110000000001000000001
100000000000100000000100010000100000010000100001
110000001010010000200100100000000000000100010001
100000000000001001010010000001000000000100010001
101001000000001000000000000000010001010010000001
101000010001100000000010000000000100110000000001
100110000001001000100000010010000000100000000101
111000100000010001000000000110000100000002000011
110010000000000000000000000000100010000001010001
100010000100000000000001000011000100001000010001
100000000011000010100000000000110000000100010101
100100001001001000000001010100000011110000001011
100001111010010000110010100000000000001000000011
101000010010000000000001000000010000000000000001
101010100000100100000001101000000010001100000011
101000010000102000010000000101100010001011110001
101000001000011000000000100000000000000000001001
110010100000100000001002000000000010000000000001
111000001000000000020010000000000001000000000001
101001000001000210100100000010001001100001000101
100000010000000100000001000010000000100000010001
101101000000000001002111100100000000100100020001
100101000000011001000001100000000101010000010101
100000000000010100010100000001011100000101100011
100000000001100000010100001001000000000000010111
100001000110000100000010000000100001100100001001
100001000000000000000001100100100000010000010001
100000000000001000000000000010000001000010010011
110001000000010000000001001000001000001100000101
100010020100000000000000001000000000100010001001
111201000000001010000000010000101000000000010001
120000100000000010010000000200100100001000100001
110000002000000000000001000001000000011000000111
100000000000000000011001000101100001000001000101
101200112000010001001100001010000100000101010111
110020000000000000000000002100110000100010000101
110010200001000000000000100000010100101100200001
100010010100001000000110000000000010101000000111
100000010000000010000000000100000100010000000101
101100011000110010000001000110010001000000000001
100000000000010100000000000000112010000001100101
101110001000000001000011000100000010000100002001
100010000000000000000001000010012001001110000001
100000000000000011000000001010010000001001001101
100001100000000000100100010000000100100000000011
100000001011000001000001000010000000000000000001
110100010000000010000010000000010000100001011001
110000000101000000101010100010000000000111000001
101000010002000011000100101100000101000000111001
100001000010000000000000010000100010100011001001
100010002110000000000000010000100001010101010001
100100100010000000000000001000001000000000000001
100101010000101100000010100000000001100010001011
100001100000000100010000010000000000000100100001
100001100000011011110000011001000011101000000001
100110210010010000000000010100000010100000010011
110010010000001001000000000000000000000000100001
100010011000100000000000000010000000000010000011
110000110100010001000000000000000000000001000101
100000100000000100101010000000001101001000000201
111000001001000010000201000000000000020000000001
100000110100010100010101001100000010010000011001
100001010100000000100000100001000011000000000001
100000101000001000010010010000000000000001000001
102101001000001200000002100000000020011000100001
100100000000011000010000000001100000010001001101
101101001000000000000000000111100000000000010001
101000000000110001000000100010000000000000010001
100001001001001000000010011000001000100100101001
100000001000000101100000000000000000100000100011
110001101000000000100101000101000000010100001011
101000100010000000000101000001000000011000111001
100000000000000000100010000100000000000100010001
100010001000000010001100201000000010000000100001
110000000000010000000000010000000101011000000001
100000010010001000000000010000001110011011002011
100110010000001010100001000000100110000001000001
100100000000000010000000000001101002000010000001
100100100000010100000000000000110000100000000201
100010100000000000000000000000000000010000001021
100000000011010010000100000000000010000001010101
100100000000001000000000101020000000001010001011
110011100001100000000000011100000000100010000001
100000000000100010100000000200000000002001000011
101010000010000110011001001001001000000000000001
100100000010110010001011000001000000010000000001
100001100010000000100000011000000000000111101101
110100100000000201000000000001000101000100110101
100100010010000000100000000001010100000200000001
100010000100000001011101000000000100000001100101
100000000001111100000000100000000000000011100001
100000000000001001100010001100000000000000000101
101001010110001000001000000000010000001101000001
101010000000000001000001000000000100000000000011
100000001000010010100001000001100001010001000011
100001001000000010100000000001010010000100110001
110000000000000000001010100000001010100010000001
100001010010101100011100000011110100000001000001
100111000100111000000000010101100000010001011011
100011110000000100010100000000010001000100102001
101000011010000000000010000000100100000001000001
100000000000000000000100100100100010000000001101
101001110100010000000000100010110000010100101101
101010001010001000210001010000000010010000010101
100111000000001000000000000010000010000110000001
110200100002001011100101000100000000000001100001
100000010011000010010000010100000000100000000001
100020000100000000000000010001000000000110000101
101200001101002000111000011000100101000000000001
100010000000111001100000000000000000000010001001
100010000110000100100110000100000001001001000001
111000000000001000010000000101000000100000100101
100001110000000000100101000000000120010000000011
100000101201001010000001000000000010010001001011
100101000100000000100001000000000001000010011001
100001000000000110000010000000111100000000101001
111111111111111111111111111111111111111111111111
