R 1000 1000


NO ./textures/xpm/bluestone.xpm
SO ./textures/xpm/colorstone.xpm
WE ./textures/xpm/greystone.xpm
EA ./textures/xpm/mossy.xpm
S ./textures/xpm/barrel.xpm
F 136,66,29


C 242,255,255
111111111111111111111111
120000000001000000000021
1N0000000001111000000001
100000000000001000000001
100000000001001000000001
111111111111001000000001
100001200000001000000001
100000000000000000000001
100000000000000000000001
100000000000000000000001
100000000000000000000001
100000000200000000000001
100000000000000000000001
100000000000000002000001
100000000000000000020001
100000000000000002000001
100000000000000000000001
120000000000000000000021
111111111111111111111111